111111111111111111111
1E0000000100000000001
1C0010100000000000011
1P0010100000000000001
111111111111111111111